Level 0:
#######
#----X#
#-----#
#--P--#
#-----#
#-----#
#######
