Level 0:
#########
#---##-X#
#---#--##
#####-###
#-----###
#P-###--#
#########

Level 1:
#########
######-X#
#P-----##
#########

Level 2:
#########
######-X#
#P-----##
#########

