Level 0:
##############################
#POOOOOOOOOOOOOOOOOOOOOOOOOOO#
#OCXOOOOOOOOOOOOOOOOOOOOOOOOO#
#OCXOOOOOOOOOOOOOCXOOOOOOOOOO#
#OOOOOOOOOOOOOOOOOOOOOOOOOOOO#
#OOOOOOOOOOOOOOOOOOOOOOOOOOOO#
#OOOOOOOOCOOOOOOOOOOOXOOOOOOO#
#OOOOOOOOOOOOOOOOOOOOOOOOOOOO#
#OOOOOOOOOOOOOOOOOOOOOOOOOOOO#
#OOOOOOOOOOOOOOOOOOOOOOOOOOOO#
#OOOOOOOOOOOOOOOOOOOOOOOOOOOO#
#OOOOOOOOOOOOOOOOOOOOOOOOOOOO#
#OOOOOOOOOOOOOOOOOOOOOOOOOOOO#
#OOOOOOOOOOOOOOOOOOOOOOOOOOOO#
#OOOOOOOOOOOOOOOOOOOOOOOOOOOO#
#OOOOOOOOOOOOOOOOOOOOOOOOOOOO#
#OOOOOOOOOOOOOOOOOOOOOOOOOOOO#
#OOOOOOOOOOOOOOOOOOOOOOOOOOOO#
#OOOOOOOOOOOOOOOOOOOOOOOOOOOO#
##############################

Level 1:
##############################
#OOOOOOOOOOOOOOOOOOOPOOOOOOOO#
#OCXOOOOOOOOOOOOOOOOOOOOOOOOO#
#OOOOOOOOOOOOOOOOOOOOOOOOOOOO#
#OOOOOOOOOOOOOOOOOOOOOOOOOOOO#
#OOOOOOOOOOOOOOOOOOOOOOOOOOOO#
#OOOOOOOOOOOOOOOOOOOOOOOOOOOO#
#OOOOOOOOOOOOOOOOOOOOOOOOOOOO#
#OOOOOOOOOOOOOOOOOOOOOOOOOOOO#
#OOOOOOOOOOOOOOOOOOOOOOOOOOOO#
#OOOOOOOOOOOOOOOOOOOOOOOOOOOO#
#OOOOOOOOOOOOOOOOOOOOOOOOOOOO#
#OOOOOOOOOOOOOOOOOOOOOOOOOOOO#
#OOOOOOOOOOOOOOOOOOOOOOOOOOOO#
#OOOOOOOOOOOOOOOOOOOOOOOOOOOO#
#OOOOOOOOOOOOOOOOOOOOOOOOOOOO#
#OOOOOOOOOOOOOOOOOOOOOOOOOOOO#
#OOOOOOOOOOOOOOOOOOOOOOOOOOOO#
#OOOOOOOOOOOOOOOOOOOOOOOOOOOO#
##############################

Level 2:
##############################
#OOOOOOOOOOOOOOOOOOOPOOOOOOOO#
#OOOOOOOOOOOOOOOOOOOOOOOOOOOO#
#OOOOOOOOOOOOOOOOOOOOOOOOOOOO#
#OOOOOOOOOOOOOOOOOOOOOOOOOOOO#
#OOOOOOOOOOOOOOOOOOOOOOOOOOOO#
#OOOOOOOOOOOOOOOOOOOOOOOOOOOO#
#OOOOOOOOOOOOOOOOOOOOOOOOOOOO#
#OOOOOOOOOOOOOOOOOOOOOOOOOOOO#
#OOOOOOOOOOOOOOOOOOOOOOOOOOOO#
#OOOOOOOOOOOOOOOOOOOOOOOOOOOO#
#OOOOOOOOOOOOOOOOOOOOOOOOOOOO#
#OOOOOOOOOOOOOOOOOOOOOOOOOOOO#
#OOOOOOOOOOOOOOOOOOOOOOOOOOOO#
#OOOOOOOOOOOOOOOOOOOOOOOOOOOO#
#OOOOOOOOOOOOOOOOOOOOOOOOOOOO#
#OOOOOOOOOOOOOOOOOOOOOOOOOOOO#
#OOOOOOOOOOOOOOOOOOOOOOOOOOOO#
#OOOOOOOOOOOOOOOOOOOOOOOOOOOO#
##############################